2 2 2 2 2 2 2 2 2 2 2 2 2 2 2 2 2 2 2 2 2 2 2 2 2 2 2 2 2
2 1 1 1 1 1 1 1 1 0 1 1 0 1 1 1 0 1 1 1 1 1 1 1 1 1 1 1 2
2 1 2 0 2 1 2 1 2 0 2 1 2 1 2 1 2 0 2 0 2 4 2 1 2 0 2 1 2
2 1 1 1 4 1 1 1 1 1 1 1 1 1 1 1 1 0 1 1 1 1 1 1 1 1 1 1 2
2 1 2 0 2 0 2 1 2 0 2 1 2 1 2 1 2 0 2 1 2 1 2 1 2 1 2 1 2
2 1 1 1 1 1 1 0 1 1 1 1 1 1 4 1 1 1 1 0 1 1 1 1 1 0 0 1 2
2 1 2 0 2 0 2 1 2 1 2 1 2 1 2 0 2 1 2 0 2 1 2 1 2 0 2 1 2
2 0 0 1 1 1 1 1 1 1 1 1 1 1 0 0 0 1 1 1 1 1 0 1 1 0 0 1 2
2 1 2 1 2 1 2 0 2 0 2 1 2 1 2 1 2 1 2 1 2 1 2 0 2 1 2 1 2
2 1 1 1 1 1 1 0 1 1 1 1 1 0 1 1 1 1 0 0 1 1 0 0 1 1 1 1 2
2 1 2 1 2 1 2 0 2 0 2 1 2 1 2 1 2 1 2 1 2 1 2 1 2 1 2 1 2
2 1 1 1 0 1 1 1 1 0 1 1 1 1 0 1 1 1 1 0 1 1 1 0 0 0 1 1 2
2 2 2 2 2 2 2 2 2 2 2 2 2 2 2 2 2 2 2 2 2 2 2 2 2 2 2 2 2
ENEMY1 27 1
ENEMY1 8 5
ENEMY1 15 11
ENEMY2 23 6
ENEMY2 17 6
ENEMY3 7 1
ENEMY4 5 11