2 2 2 2 2 2 2 2 2 2 2 2 2 2 2 2 2 2 2 2 2 2 2 2 2 2 2 2 2
2 1 1 0 1 1 1 1 1 1 1 1 0 0 0 1 1 1 1 1 0 0 1 1 1 1 1 1 2
2 1 2 0 2 1 2 1 2 0 2 1 2 0 2 1 2 1 2 1 2 4 2 1 2 1 2 1 2
2 1 1 1 1 1 1 1 1 1 1 1 1 1 1 1 1 1 1 1 1 0 0 1 1 1 1 1 2
2 1 2 0 2 0 2 1 2 1 2 0 2 1 2 1 2 1 2 1 2 1 2 1 2 1 2 0 2
2 1 1 1 1 1 1 0 1 1 1 0 0 1 4 1 1 1 1 0 1 1 1 1 1 0 0 0 2
2 1 2 0 2 1 2 1 2 1 2 0 2 1 2 0 2 1 2 0 2 1 2 1 2 1 2 1 2
2 0 0 1 1 1 1 1 1 1 1 1 1 1 0 0 0 1 1 1 1 1 0 1 1 0 0 1 2
2 1 2 1 2 1 2 0 2 0 2 1 2 1 2 1 2 1 2 1 2 1 2 0 2 0 2 1 2
2 1 1 1 1 1 1 1 1 1 1 1 1 0 1 1 1 1 0 0 1 1 0 0 1 1 1 1 2
2 1 2 1 2 1 2 1 2 0 2 1 2 1 2 1 2 1 2 1 2 1 2 1 2 1 2 1 2
2 1 1 1 0 1 1 0 1 0 1 1 1 1 0 1 1 1 1 0 0 1 1 1 1 1 1 1 2
2 2 2 2 2 2 2 2 2 2 2 2 2 2 2 2 2 2 2 2 2 2 2 2 2 2 2 2 2
ENEMY1 26 1
ENEMY1 7 6
ENEMY2 27 11
ENEMY3 17 5
ENEMY4 4 1
ENEMY3 12 11