9 9 9 9 9 9 9 9 9 9 9 9 9 9 9 9 9 9 9 9 9 9 9 9 9 9 9 9 9
2 2 2 2 2 2 2 2 2 2 2 2 2 2 2 2 2 2 2 2 2 2 2 2 2 2 2 2 2
2 1 1 0 13 1 1 1 1 1 1 1 0 0 0 1 1 1 1 1 0 0 1 1 1 1 10 1 2
2 1 2 0 2 1 2 1 2 0 2 1 2 0 2 1 2 1 2 1 2 4 2 1 2 1 2 1 2
2 1 1 1 1 1 1 1 1 1 1 1 1 1 1 1 1 1 1 1 1 0 0 1 1 1 1 1 2
2 1 2 0 2 0 2 1 2 1 2 0 2 1 2 1 2 1 2 1 2 1 2 1 2 1 2 0 2
2 1 1 1 1 1 1 0 1 1 1 0 0 1 4 1 1 12 1 0 1 1 1 1 1 0 0 0 2
2 1 2 0 2 1 2 10 2 1 2 0 2 1 2 0 2 1 2 0 2 1 2 1 2 1 2 1 2
2 0 0 1 1 1 1 1 1 1 1 1 1 1 0 0 0 1 1 1 1 1 0 1 1 0 0 1 2
2 1 2 1 2 1 2 0 2 0 2 1 2 1 2 1 2 1 2 1 2 1 2 0 2 0 2 1 2
2 1 1 1 1 1 1 1 1 1 1 1 1 0 1 1 1 1 0 0 1 1 0 0 1 1 1 1 2
2 1 2 1 2 1 2 1 2 0 2 1 2 1 2 1 2 1 2 1 2 1 2 1 2 1 2 1 2
2 1 1 1 0 1 1 0 1 0 1 1 12 1 0 1 1 1 1 0 0 1 1 1 1 1 1 11 2
2 2 2 2 2 2 2 2 2 2 2 2 2 2 2 2 2 2 2 2 2 2 2 2 2 2 2 2 2

0 - Brick
1 - Grass
2 - Wall
4 - Item

10 - Enemy1
11 - Enemy2
12 - Enemy3
13 - Enemy4